NO ./img/wall_n.xpm
SO ./img/wall_s.xpm
WE ./img/wall_w.xpm
EA ./img/wall_e.xpm

R 960 740
S ./img/2.xpm
F ./img/mossy.xpm
C 255,255,244

11111111111111111111111111111111111111111111111
10000000000000000000000001000000000000200200001
10W01121111101110211111111111000002000002002001
10000000000100000000000000000020000000200000001
11111021111111111111111001111111111111111111001
10020000010000000020000001000000100000000001001
10000200012111111100000201002000100111110001001
10000000010000000100200001000000100120010001001
11111110110002000100000001000200100100000001001
10000000010000000111011111000000100111111111001
10000020010200000000000000000000100000000000001
10000000010000200000000200020000111111111111111
10000000010000000000000000000000100000200000001
10000000011111111111111111111111100000000200001
10000000090000000000000000000000000000200000001
11111111111111111111111111111111100000000200001
10000000000000000000000000000000100000200000001
10000000000000000000000000000000100000000200001
10000000000000000000000000000000100000200000001
11111111111111111111111111111111111111111111111
