NO ./img/con/wall_dark3.xpm
SO ./img/con/wall_dark3.xpm
WE ./img/con/wall_dark3.xpm
EA ./img/con/wall_dark3.xpm

R 960 740
S ./img/2.xpm
F ./img/con/floor_wood.xpm
C ./img/con/floor_wood.xpm

1111111111111111111111111111111111111
1110000000000000000000000000000000001
1000002000000000020000000000000000001
1000000000000000000000000000000000001
1000000002000000000000000000000000001
1000001000000000000000000000000000001
1000001000000000000000000000000000001
100000100000000000W000000000000000001
1000009000000000000000000000000000001
1000001000000000000000000000000000001
1000001000000000000000000000000000001
1000000000020000000000000000000000001
1000000000000000000000000000000000001
1000000000000000000000000000000000001
1111111111111111111111111111111111111
