NO ./img/wall_n.xpm
SO ./img/wall_s.xpm
WE ./img/wall_w.xpm
EA ./img/pack_2_resize.xpm

R 960 740
S ./img/2.xpm
F ./img/mossy.xpm
C 200,200,210

1111111111111111111111111111111111111
1110000000000000000000000000000000001
1000002000000000020000000000000000001
1000000000000000000000000000000010001
1000000000000000000000000000000010001
1000000000000000000000000000000010001
1111111111111111111111111111111111111
