NO ./img/wall_n.xpm
SO ./img/wall_s.xpm
WE ./img/wall_w.xpm
EA ./img/wall_e.xpm

R 960 740
S ./img/2.xpm
F ./img/mossy.xpm
C ./img/bluestone.xpm

1111111111111111111111111111111111111
1110000000000000000000000000000000001
1111112101110000020000000000000000001
1000000000010000000000000000000000001
1111102001111110011111111111111111111
1000000001000000000000000000000010001
1000002001000000000000000000000010001
1000000001000000000W00000000000010001
1000000001000000000000000000000010001
1000000001000000000000000000000010001
1000002001000000000000000000000010001
1000000001000000000000000000000010001
1000000001000000000000000000000010001
1000000001111111111111111111111110001
1000000001000000000000000000000010001
1111119111000000000000000000000010001
1000000000000000000000000000000010001
1000000000000000000000000000000010001
1000000000000000000000000000000010001
1000000000000000000000000000000010001
1000000000000000000000000000000010001
1000000000000000000000000000000010001
1000000000000000000000000000000010001
1000000000000000000000000000000010001
1000000000000000000000000000000010001
1000000000000000000000000000000010001
1000000000000000000000000000000010001
1000000000000000000000000000000010001
1000000000000000000000000000000010001
1000000000000000000000000000000010001
1000000000000000000000000000000010001
1000000000000000000000000000000010001
1000000000000000000000000000000010001
1000000000000000000000000000000010001
1000000000000000000000000000000010001
1000000000000000000000000000000010001
1000000000000000000000000000000010001
1000000000000000000000000000000010001
1000000000000000000000000000000010001
1000000000000000000000000000000010001
1000000000000000000000000000000010001
1000000000000000000000000000000010001
1000000000000000000000000000000010001
1000000000000000000000000000000010001
1000000000000000000000000000000010001
1000000000000000000000000000000010001
1000000000000000000000000000000010001
1000000000000000000000000000000010001
1000000000000000000000000000000010001
1000000000000000000000000000000010001
1000000000000000000000000000000010001
1000000000000000000000000000000010001
1000000000000000000000000000000010001
1000000000000000000000000000000010001
1000000000000000000000000000000010001
1111111111111111111111111111111111111
