R 640 480
NO ./img/NO.xpm
SO ./img/SO.xpm
WE ./img/WE.xpm
EA ./img/EA.xpm

S ./img/2.xpm
F ./img/mossy.xpm
C 255,243,234

1111111111111111111111111111111111111
1110000000000000000000000000000000001
1000002000000000000000000000000000001
10000000000000E0000000000000000000001
1000002000000000000000000000000010001
1000000000000000000000000000000010001
1000002000000000000000000000000010001
1111111111111111111111111111111111111
