NO ./img/wall_n.xpm
SO ./img/wall_s.xpm
WE ./img/wall_w.xpm
EA ./img/wall_e.xpm

R 960 740
S ./img/2.xpm
F ./img/wood.xpm
C ./img/wood.xpm

1111111111111111
1000000000000001
10000000N0000001
1020000000000001
1000000000000001
1000001191100001
1000000000000001
1000200000000001
1000000000000001
1000002000000001
1000000000000001
1111111111111111
