1111111111111111111111111111111111111
1110000000000000000000000000000000001
1000000000000000000000000000000000001
10000000000000N0000000000000000000001
1000000000000000000000000000000000001
1000000000000000000000000000000000001
1000000000000000000000000000000000001
1111111111111111111111111111111111111
