        1111111111111111111111111
        1000000000000000000000001
        1100000000000000000000001
        1000000000002000000000001
111111111000000000000000000000001
100000000000000000000000000001111
10000000000000010000000000001
1000000000000000000000N000001
10000000000000000000000000001
10000000000000000000000000001
10000000000000000001010000001
11000001110101011111011110101
11110111 1110121 101111010001
